ZenMate VPN - fdcgdnkidjaadafnichfpabhfomcebme
1clickVPN - fcfhplploccackoneaefokcmbjfbkenj
Touch VPN - bihmplhobchoageeokmgbdihknkjbknd
Hola Free VPN - gkojfkhlekighikafcpjkiklfbnlmeio
Astar VPN - jajilbjjinjmgcibalaakngmkilboobh
VPN Free - gjknjjomckknofjidppipffbpoekiipm
Earth VPN - nabbmpekekjknlbkgpodfndbodhijjem
DotVPN - kpiecbcckbofpmkkkdibbllpinceiihk
Hotspot Shield Free VPN - nlbejmccbhkncgokjcmghpfloaajcffj
Browsec VPN - omghfjlpggmjjaagoclmmobgdodcjboh
VPN-free.pro - bibjcjfmgapbfoljiojpipaooddpkpai
VPN Unlimited Free - mpcaainmfjjigeicjnlkdfajbioopjko
PP VPN - jljopmgdobloagejpohpldgkiellmfnc
IP Unblock - lochiccbgeohimldjooaakjllnafhaid
Surf VPN - nhnfcgpcbfclhfafjlooihdfghaeinfc
iNinja VPN - ookhnhpkphagefgdiemllfajmkdkcaim
Daily VPN - namfblliamklmeodpcelkokjbffgmeoo
Hoxx VPN Proxy - nbcojefnccbanplpoffopkoepjmhgdgh
Free VPN - majdfhpaihoncoakbjgbdhglocklcgno
VPN PROXY MASTER - lnfdmdhmfbimhhpaeocncdlhiodoblbd
Urban Free VPN - eppiocemhmnlbhjplcgkofciiegomcon
SaferVPN Proxy - cocfojppfigjeefejbpfmedgjbpchcng
VPN Professional - foiopecknacmiihiocgdjgbjokkpkohc
AdGuard VPN - hhdobjgopfphlmjbmnpglhfcgppchgje
Free VPN - jgbaghohigdbgbolncodkdlpenhcmcge
Free One Touch VPN - inligpkjkhbpifecbdjhmdpcfhnlelja
Unlimited VPN & Proxy by ibVPN - higioemojdadgdbhbbbkfbebbdlfjbip
RusVPN - hipncndjamdcmphkgngojegjblibadbe
Azino VPN - iolonopooapdagdemdoaihahlfkncfgg
Pron VPN - nhfjkakglbnnpkpldhjmpmmfefifedcj
Free Residential VPN - jpgljfpmoofbmlieejglhonfofmahini
ExpressVPN - fgddmllnllkalaagkghckoinaemmogpe
Hotspot Shield Elite VPN Proxy - ejkaocphofnobjdedneohbbiilggdlbi
Hide My IP VPN - keodbianoliadkoelloecbhllnpiocoi
Tunnello VPN - hoapmlpnmpaehilehggglehfdlnoegck
HMA VPN Proxy Unblocker - poeojclicodamonabcabmapamjkkmnnk
Free Avira Phantom VPN - dfkdflfgjdajbhocmfjolpjbebdkcjog
Hola VPN - kcdahmgmaagjhocpipbodaokikjkampi
Free VPN for Chrome - klnkiajpmpkkkgpgbogmcgfjhdoljacg
Hub VPN - lneaocagcijjdpkcabeanfpdbmapcjjg
Free Proxy VPN - pgfpignfckbloagkfnamnolkeaecfgfh
Private Internet Access - jplnlifepflhkbkgonidnobkakhmpnmh
Turbo VPN for PC - jliodmnojccaloajphkingdnpljdhdok
Windscribe - hnmpcagpplmpfojmgmnngilcnanddlhb
CyberGhost VPN - ffbkglfijbcbgblgflchnbphjdllaogb
VPN.AC - kcndmbbelllkmioekdagahekgimemejo
Browser VPN - jdgilggpfmjpbodmhndmhojklgfdlhob
DEEPRISM VPN - bihhflimonbpcfagfadcnbbdngpopnjb
My Browser Vpn - ppajinakbfocjfnijggfndbdmjggcmde
SetupVPN - oofgbpoabipfcfjapgnbbjjaenockbdp
Wachee VPN - bhnhkdgoefpmekcgnccpnhjfdgicfebm
Thunder Proxy - knmmpciebaoojcpjjoeonlcjacjopcpf
Free Proxy VPN - dhadilbmmjiooceioladdphemaliiobo
FastestVPN Proxy - jedieiamjmoflcknjdjhpieklepfglin
WorkingVPN - mhngpdlhojliikfknhfaglpnddniijfh
TunnelBear VPN - omdakjcmkglenbhjadbccaookpfjihpa
BelkaVPN - npgimkapccfidfkfoklhpkgmhgfejhbj
VPN Master - akeehkgglkmpapdnanoochpfmeghfdln
Unblock Websites - gbmdmipapolaohpinhblmcnpmmlgfgje
Lethean Proxy VPN - aigmfoeogfnljhnofglledbhhfegannp
Whoer VPN - cgojmfochfikphincbhokimmmjenhhgk
Best VPN USA - ficajfeojakddincjafebjmfiefcmanc
FREE VPN DEWELOPMENT - ifnaibldjfdmaipaddffmgcmekjhiloa
apkfold free vpn - jbnmpdkcfkochpanomnkhnafobppmccn
Soul VPN - apcfdffemoinopelidncddjbhkiblecc
DotVPN - mjolnodfokkkaichkcjipfgblbfgojpa
rderzh VPN Proxy - oifjbnnafapeiknapihcmpeodaeblbkn
Red Panda VPN - plpmggfglncceinmilojdkiijhmajkjh
Ultrareach VPN - mjnbclmflcpookeapghfhapeffmpodij
FastStunnel VPN - bblcccknbdbplgmdjnnikffefhdlobhp
VirtualShield VPN - aojlhgbkmkahabcmcpifbolnoichfeep
Adblock Office VPN Proxy Server - lcmammnjlbmlbcaniggmlejfjpjagiia
Guru VPN & Proxy - knajdeaocbpmfghhmijicidfcmdgbdpm
Malus VPN - bdlcnpceagnkjnjlbbbcepohejbheilk
Muscle VPN - edknjdjielmpdlnllkdmaghlbpnmjmgb
Push VPN - eidnihaadmmancegllknfbliaijfmkgo
Gom VPN - ckiahbcmlmkpfiijecbpflfahoimklke
Free Fast VPN - macdlemfnignjhclfcfichcdhiomgjjb
BullVPN - chioafkonnhbpajpengbalkececleldf
HideAll VPN - amnoibeflfphhplmckdbiajkjaoomgnj
ProxyFlow - llbhddikeonkpbhpncnhialfbpnilcnc
Cloud VPN - pcienlhnoficegnepejpfiklggkioccm
sVPN - iocnglnmfkgfedpcemdflhkchokkfeii
Social VPN - igahhbkcppaollcjeaaoapkijbnphfhb
Trellonet Trellonet - njpmifchgidinihmijhcfpbdmglecdlb
WindmillVPN - ggackgngljinccllcmbgnpgpllcjepgc
IPBurger Proxy & VPN - kchocjcihdgkoplngjemhpplmmloanja 
Veee - bnijmipndnicefcdbhgcjoognndbgkep
Anonymous Proxy Vpn Browser - lklekjodgannjcccdlbicoamibgbdnmi
Hideman VPN - dbdbnchagbkhknegmhgikkleoogjcfge
Fornex VPN - egblhcjfjmbjajhjhpmnlekffgaemgfh
WeVPN - ehbhfpfdkmhcpaehaooegfdflljcnfec
VPNMatic - bkkgdjpomdnfemhhkalfkogckjdkcjkg
Urban Shield - almalgbpmcfpdaopimbdchdliminoign
Prime VPN - akkbkhnikoeojlhiiomohpdnkhbkhieh
westwind - gbfgfbopcfokdpkdigfmoeaajfmpkbnh
Upnet - bniikohfmajhdcffljgfeiklcbgffppl
uVPN - lejgfmmlngaigdmmikblappdafcmkndb
Nucleus VPN - ffhhkmlgedgcliajaedapkdfigdobcif
Touch VPN - bihmplhobchoageeokmgbdihknkjbknd
FoxyProxy Standard - gcknhkkoolaabfmlnjonogaaifnjlfnp
GeoProxy - pooljnboifbodgifngpppfklhifechoe
NordVPN - fjoaledfpmneenckfbpdfhkmimnjocfa
ProxFlow - aakchaleigkohafkfjfjbblobjifikek
Proxy SwitchySharp - dpplabbmogkhghncfbfdeeokoefdjegm
Proxy SwitchyOmega - padekgcemlokbadohgkifijomclgjgif
PureVPN - bfidboloedlamgdmenmlbipfnccokknp
RusVPN - hipncndjamdcmphkgngojegjblibadbe
SaferVPN - cocfojppfigjeefejbpfmedgjbpchcng
TunnelBear VPN - omdakjcmkglenbhjadbccaookpfjihpa